 DragonMouth = { 
	2283 1318 2282 2281 2284 1306 61 59 62 60
	50 58 51 49 54 57 56 55 53 52
	47 48 46 43 45 44 42 41 11 4811
	2 12 3 4 5 6 7 8 9 10
	14 13 38 39 37 35 33 32 31 16
	15 17 18 19 20 21 30 28 22 23
	25 27 26 24 29 34 40 36 218 219
	240 
}
