DragonMouth = { 
	2283 1318 2282 2281 2284 1306 61 59 62 60
	50 58 51 49 54 57 56 55 53 52
	47 48 46 43 45 44 42 41 11 4811
	2 12 3 4 5 6 7 8 9 10
	14 13 38 39 37 35 33 32 31 16
	15 17 18 19 20 21 30 28 22 23
	25 27 26 24 29 34 40 36 218 219
	240 
}
dontuse = { 
	4153 
}
CAmerica1 = { 
	4111 4106 4112 4109 4117 4116 4115 4110 4113 4114
	4120 4104 4105 4107 4122 4123 4131 4132 4125 4124
	4129 4126 4128 4127 4130 4158 5464 5465 4157 4154
	4156 4118 4119 4121 4195 5466 2390 5467 4199 4196
	4200 4201 4198 4202 4147 4148 4149 4204 4205 4206
	4133 4138 4146 4139 4159 4160 4137 4136 4144 4143
	4145 4165 4161 4166 4169 4226 4170 4227 4168 4167
	4229 4172 4175 4174 4171 4162 4163 4164 4140 4141
	4142 4176 4177 4180 4181 4179 4178 4184 4185 4186
	4187 4188 4190 4189 4182 4183 4228 4233 4230 4231
	4173 4191 4192 4194 4209 4210 4212 4203 4211 4213
	4214 4216 4215 4218 4217 4208 4207 4224 4219 4221
	4222 4232 4242 4235 4238 4239 4237 4236 4241 4243
	4245 4247 4244 2393 2394 4246 4249 4250 4252 4248
	4253 4255 4254 4256 4262 4263 4269 4264 4274 4275
	4284 4257 4259 4260 4265 4268 4272 4270 4276 4304
	4285 4267 4266 4282 4283 4291 4298 4301 4296 2464
	5463 4271 4306 4308 4313 4323 4324 4326 4321 4322
	4327 4331 4329 4330 4544 4543 4541 4542 4273 4277
	4279 4278 4294 4289 4290 4288 4287 4280 4286 4281
	4292 4295 4297 4293 4300 4305 4302 4314 4303 4307
	4310 4309 4311 4316 4315 4318 4319 4368 4369 4372
	4375 4377 2392 2398 2395 2400 2402 4527 5468 2399
	2396 2397 4525 4528 4539 4545 4546 4531 4530 4526
	4529 4532 4535 4536 4534 4533 4538 4549 4540 4547
	4550 4548 4552 4556 4555 4557 5469 4554 4553 4537
	4563 4564 4565 4562 4566 4567 4568 4569 2401 4574
	4576 4575 4578 4579 4581 4577 2403 2406 2407 2408
	4584 4582 4583 4586 4589 4591 4592 4587 4590 4594
	4597 4596 4593 4611 4610 4612 4614 4615 4560 4561
	4602 4603 4601 4600 4599 4604 4605 4606 4607 4608
	4651 4609 4613 4619 4616 4620 4617 4618 4621 4623
	4622 4627 4632 4633 4634 4628 4624 4626 4630 4629
	4654 4652 4653 4638 4625 4637 4635 4640 4636 4643
	4642 4644 4646 4648 4641 4650 4649 4647 4645 2409
	2412 4657 4656 4655 4660 4659 4658 4661 4663 4662
	4664 4666 4669 4667 4670 4668 4672 4676 4671 4678
	4694 4695 4697 4698 2410 2405 4708 4707 4709 4714
	4716 4721 4720 4723 4722 4673 4677 4675 4680 4679
	4686 4681 4685 4682 4683 4684 2411 4688 4689 4691
	4690 4692 2404 4700 4702 4699 4705 4704 4706 4710
	4711 4715 4712 4718 4713 4717 4724 4725 4728 4108
	4197 4155 4225 4223 4220 4193 4234 4261 4135 4258
	4240 4251 4299 4312 4317 4551 4570 4571 4580 4572
	4585 4573 4588 4559 4595 4598 4639 4631 4674 4693
	4696 4665 4687 4701 4727 4729 4730 4371 4703 2442
	2441 2444 2443 2413 2710 2709 2715 2703 2702 5470
	2707 2705 2708 2704 2712 2711 2714 2713 4719 4734
	4726 4735 4732 4733 4731 4736 4739 4741 4740 4737
	4744 4743 4742 4749 4750 4746 4747 4748 4751 4745
	4758 4762 4763 4759 4761 4774 4775 4777 4773 4772
	4770 4771 4768 4752 4789 2706 4738 4756 4755 4753
	4757 4754 4767 4766 4764 4769 4765 4787 4788 4785
	4786 4796 4793 4792 4794 4797 4795 4798 4802 4790
	4791 4799 4339 4340 4341 4779 4778 5524 4780 4776
	4782 4781 4784 4783 4806 4807 4337 4338 5471 4343
	4333 4332 4334 4325 4328 4346 4336 4335 4347 4345
	4356 4342 4344 4357 4353 4355 4358 4361 4360 4359
	4362 4365 4363 4364 4397 4760 4374 4381 4380 4378
	4373 4349 4370 4348 4320 4352 4354 4351 4350 4383
	4379 4386 4387 4391 4382 4385 4388 4384 4389 4390
	4393 4394 4392 4376 
}
CAmerica2 = { 
}
America106 = { 
}
